111111111111111111111111111111111101
100000000000000000000000000000000001
101111101111111111111100000010000001
101000111111000000000100000000000101
101011001101111111110100000000000101
101011010100000100000100000000100101
101011010101111110000000000111100001
101000000000000000000000000000000101
101111011111101101000000111111111101
100000010000101101000000100010000101
100000011110100001001111101010110101
100001010000110001000000001000110101
111101010100100001000011111111110101
100001010111101101000100010000010101
101101000000000101010001000101000101
100001011111111101111111111101111101
111101000000011111111110000000000101
100001111111100011110000011110111101
101111100010001000100010000000000101
100111001000100010101110101011111111
101111111110011110101010101100010101
100010011110000000101010101001000101
101010111000001111101011101011110101
101010011111100000101000101000010001
111011110001111110101010101011110111
100000000001111100101010001000000001
101111111111100101000011111011111101
100001000000000000001010000000000101
101111010000110110101000000000000001
100000010000000000101000000000000001
100000000111100000000000001111101101
100000000001000000001100000011101101
100010010001010000000000100010000001
100000000001011000111010101011101101
100000100001110000000010001001111001
101111111111111111111111111111111111
